NO textures/red_brick.xpm
EA textures/blue_wall.xpm
SO textures/oner.xpm
WE textures/faker.xpm

F 255,255,255
C 153,255,255


111111111111111111111
100000000000000000001
100000000000000000001
100000000000000000001
100001000111000100001
100000000000000000001
100000000000000000001
100000000000000000001
100000000000000000001
100000000000000000001
100000000000000000001
100000000000000000001
100000000N00000000001
111111111111111111111


