NO textures/simonkraft/wet_sponge.xpm
SO textures/simonkraft/wet_sponge.xpm
WE textures/simonkraft/wet_sponge.xpm
EA textures/simonkraft/wet_sponge.xpm

F 164,169,20
C 153,204,255




111111111111111111111
100000000000000000001
100000000000000000001
100000000000000000001
100001000111000100001
100000000000000000001
100000000000000000001
100000000000000000001
100000000000000000001
100000000000000000001
100000000000000000001
100000000000000000001
1000000000N0000000001
111111111111111111111


