NO textures/red_brick.xpm
SO textures/red_brick.xpm
WE textures/red_brick.xpm
EA textures/red_brick.xpm

F 0,0,0
C 130, 128, 255




111111111111111111111
100000000000000000001
100000000000000000001
100000000000000000001
100001000111000100001
100000000000000000001
100000000000000000001
100000000000000000001
100000000000000000001
100000000000000000001
100000000000000000001
100000000000000000001
100000000N00000000001
111111111111111111111


