F 76,76,76
C 92,99,99

NO textures/simonkraft/cobblestone.xpm
SO textures/simonkraft/cobblestone_01.xpm
WE textures/simonkraft/mossy_cobblestone1.xpm
EA textures/simonkraft/cobblestone_02.xpm

111111111111111111111111111111111
100000000000000000000000000000111
100000000111111100000000000000011
100000000000000000000000000000011
100000000000011000000000000000011
100000000000000000000000000000001
100000000000000000000000000000001
100000000000000000000000000000001
100000000000000000000000000000001
100000000000000000000000000000001
100000000000000000000000000000001
100000000000000000000000000000001
100000000000000000000000000000001
100000000000000000000000000000001
100000000000100000000000000000001
100000000000N00000000000000000001
111111111111111111111111111111111

